1111111111111
1001000000MC1
100C01011C001
1PM011E000011
1111111111111